ดวง	พยาบาล	อนุรักษ์
กลม	ราชการ	โทรทัศน์
ขนม	อากาศ	นวัตกรรม
ครก	รายการ	มนุษย์
สระ	ดาวเทียม	พลเรือน
มติ	กว้างขวาง	องค์กร
ความ	การเมือง	ยุติธรรม
ผอม	สถิติ	เครือข่าย
ฟอก	ผลงาน	สถาปัตย์
ภาพ	รถเมล์	ลิขสิทธิ์
กลาง	ประกวด	วิศวกร
ผล	ดนตรี	หลักฐาน
ช้าง	มะม่วง	รถยนต์
ภาค	ความรู้	ปรากฏ
สนาม	หนังสือ	นโยบาย
ฉลอง	ซุกซ่อน	วิเคราะห์
ใหญ่	เสมือน	เผ่าพันธุ์
เสริม	ตกลง	รัฐศาสตร์
สนุก	คุณค่า	ศิลปกรรม
สนิม	เอกสาร	สัมพันธ์
อนุรักษ์	ดาวเทียม	ฉลอง
โทรทัศน์	กว้างขวาง	ใหญ่
นวัตกรรม	การเมือง	เสริม
มนุษย์	สถิติ	สนุก
พลเรือน	ผลงาน	สนิม
องค์กร	รถเมล์	ดวง
ยุติธรรม	ประกวด	กลม
เครือข่าย	ดนตรี	ขนม
สถาปัตย์	มะม่วง	ครก
ลิขสิทธิ์	ความรู้	สระ
วิศวกร	หนังสือ	มติ
หลักฐาน	พยาบาล	ความ
รถยนต์	ราชการ	ผอม
ปรากฏ	อากาศ	ฟอก
นโยบาย	รายการ	ภาพ
วิเคราะห์	ซุกซ่อน	กลาง
เผ่าพันธุ์	เสมือน	ผล
รัฐศาสตร์	ตกลง	ช้าง
ศิลปกรรม	คุณค่า	ภาค
สัมพันธ์	เอกสาร	สนาม
ซุกซ่อน	อนุรักษ์	มติ
เสมือน	โทรทัศน์	ความ
ตกลง	นวัตกรรม	ผอม
คุณค่า	มนุษย์	ฟอก
เอกสาร	พลเรือน	ภาพ
ประกวด	องค์กร	ฉลอง
ดนตรี	ยุติธรรม	ใหญ่
มะม่วง	เครือข่าย	เสริม
ความรู้	สถาปัตย์	สนุก
หนังสือ	ลิขสิทธิ์	สนิม
กว้างขวาง	วิศวกร	ดวง
การเมือง	หลักฐาน	กลม
สถิติ	รถยนต์	ขนม
ผลงาน	ปรากฏ	ครก
รถเมล์	นโยบาย	สระ
พยาบาล	วิเคราะห์	กลาง
ราชการ	เผ่าพันธุ์	ผล
อากาศ	รัฐศาสตร์	ช้าง
รายการ	ศิลปกรรม	ภาค
ดาวเทียม	สัมพันธ์	สนาม