WRT	HGF	IKL
IML	GFD	PLR
NHT	FDS	QWE
FWQ	SPT	RTY
TYH	GRW	SGU
HNT	QWS	YPS
NMV	QSX	SDF
CDS	JXD	DFG
FGH	IJX	GHK
HJY	QBF	HJK
QWT	LKJ	VFR
FGB	ZXC	CDE
FNH	BCV	XSW
MLK	CVB	ZQA
YPT	BNM	WSX
WTY	MNB	EDC
GHJ	NBV	RFV
HJK	VCX	TGB
NJI	XZA	YHN
BGR	KJH	UJM
VFR	IKL	HGF
CDE	PLR	GFD
XSW	QWE	FDS
ZQA	RTY	SPT
WSX	TYU	TRW
EDC	YPS	QWS
RFV	SDF	QSX
TGB	DFG	JXD
YHN	GHK	IJX
UJM	HJK	QBF
IKL	VFR	WRT
PLR	CDE	IML
QWE	XSW	NHT
RTY	ZQA	FWQ
TYU	WSX	TYH
YPS	EDC	HNT
SDF	RFV	NMV
DFG	TGB	CDS
GHK	YHN	FGH
HJK	UJM	HJY
LKJ	QWT	VFR
ZXC	FGB	CDE
XCV	FNH	XSW
CVB	MLK	ZQA
BNM	YPT	WSX
MNB	WTY	EDC
NBV	GHJ	RFV
VCX	HJK	TGB
XZA	NJI	YHN
KJH	BGR	UJM
HGF	WRT	QWT
GFD	IML	FGB
FDS	NHT	FNH
SPT	FWQ	MLK
CRW	TYH	YPT
QWS	HNT	WTY
QSX	NMV	GHJ
JXD	CDS	HJK
IJX	FGH	NJI
QBF	HJY	BGR